11111111111111111111
10000000000000000001
10111111111111111101
10100000000000001001
10101111111111101101
10100000000001001001
10111111111101101111
10000000001000000001
11111111011111111011
10000001000000000001
10111101011111111111
10001000001000000001
11101111111011111101
10000000000000001201
11111111111111111111