11111111111111111111
10000000000000000001
10111111111111111011
10100000000000001001
10101111111111111101
10100000000000001001
10111111111111011011
10000000000001001001
11111111011101101111
10000000010001000001
11111111110101111101
10000000010120000001
10111111110111111101
10000000100000000001
11111111111111111111