11111111111111111111
10000000100000000001
10111110101111111101
10100010101000001001
10101110101011101101
10101000100010101201
10101111111110101111
10100000000000100001
10111111111011101111
10000010001000100001
11101010101010101111
10001010101010100001
11111010101110001111
10000000100000100001
11111111111111111111
